0,0,0,0,0,0,0,0,0,0,0,0,0,0,0,0
0,1,1,1,0,0,4,0,0,2,2,2,0,0,0,0
0,1,5,1,0,3,4,0,0,2,7,2,0,0,0,0
0,1,1,1,0,0,4,0,0,2,2,2,0,3,3,3
0,0,0,0,0,0,0,0,0,0,0,0,0,3,7,3
0,6,6,6,0,0,6,0,0,6,6,6,0,3,3,3
0,6,5,6,0,0,6,0,0,6,7,6,0,0,0,0
0,6,6,6,0,0,6,0,0,6,6,6,0,0,0,0
0,0,0,0,0,0,0,0,0,0,0,0,0,0,0,0
9,9,9,0,8,0,8,8,0,0,0,0,0,0,0,0
9,5,9,0,8,0,8,5,0,0,0,0,0,0,0,0
9,9,9,0,8,0,8,8,0,0,0,0,0,0,0,0
0,0,0,0,0,0,0,0,0,0,0,0,0,0,0,0
